#######################
#  #   #  #  #  #  #  #
#  #  #   #  #  #  #  #
#  #      #     #     #
#  ####   #  #  #  #  #
#  #  #   #  #  #  #  #
#     #   #  #  #    ##
#                     #
#######################