#######################
#  #   #  #  #  #  #  #
#  # a#   #  #  #  #  #
#  #      #     # b   #
#  ####   #  #  #  #  #
#  #  #   #  #  #  #  #
#     #   #  #  #    ##
#  x                  #
#######################